0000000000000000
8110000000000000
0010000000000000
0010001111110000
0010001000010000
0011111000010000
0000000000010000
0000000000010000
0000000000010000
0000000000011119
0000000000000000
0000000000000000
