0000000000000000
8111100000000000
0000100000000000
0000100011111119
0000100010000000
0000100010000000
0000100011111110
0000100000000010
0000111111111110
0000000000000000
0000000000000000
reverse!
4
1 2 3 4 4 4 2 3 3 3 3 2 2 1 1 1 1 4