0000001111110000
8110001000010000
0010001000010000
0010001000010000
0010001000010000
0011111000010000
0000000000010000
0000000000010000
0000000000011119
0000000000000000
0000000000000000
