0000000000000000
8110000000000000
0010001111110000
0010001000010000
0010001000010000
0011111000010000
0000000011110000
0000000010000000
0000000011111119
0000000000000000
0000000000000000
