0000000000000000
0000000000000000
9111111111000000
0000000001000000
0000000001000000
0000000001000000
0000000001000000
0000000001111111
0000000000000001
0000000000000001
0000000000081111
reverse!
1 1 2 2 2 2 2 2 1 1 1 2 3 3 3
